#.~~~~..#..~~.#..~..
##..#~~..~~##.~##.~~
..#~.##.#~.#~#~#~~~#
~#~~~.~.~#~.~~~.....
#.#.###~##.##~.#.~..
.....#~~##~~##.~.#.#
.~~#~.~...#.~~#.~.~#
.~~#.~##.#~#..~~....
.~#.~~#..##~~#~.#...
#.....~#~.#.~#~#.~.#