...~.~~~##~~~~...#~#
#..###~.~...#~~.#..#
###.~#..~#.~~.#.~~~~
#..~~...#.~#.#.~~..~
..~~#~~~~...~~.~#~.~
~#~.#~#~~#~.###~#.##
...~~~...##..##~.#..
~#.#.~##.~.~#~.#.~~#
.~~#.~#.###..~..#...
.~~.~~###~~#~..~..~.